00000000000000000000
00000000000000000000
00000000000000000000
00000000000000000000
22200000000000002220
00000000000000002000
00000000000000022000
00000000000222000000
00000000000000000000
00000000222200000000
00000002000000000000
22000000000000000002
11222002220000002222
11111000112200001111
11111200001000221111
11111110000001111111
11111111100000011111
11111111111110011111